11111111111111111111
11111111111111111111
11444444444444444411
11444444444444444411
11444444444444444411
11444444444444444411
11444444434444444411
11444444444444444411
11444444444444444411
11444444424444444411
11444444444444444411
11444444434444444411
11444444444444444411
11444444444444444411
11444444444444444411
11444555555544444411
11444444444444444411
11444444444444444411
11111111111111111111
11111111111111111111